16,15

----------------
-----######-----
######    ######
      ....      
      ....      
######....######
-----#....#-----
-----#....#-----
-----##  ##-----
------#  #------
------#  #------
------#  #------
------#  #------
------#  #------
------#  #------

- NONE
# WALL
  FLOOR
. RUBBLE