16,15

----------------
-----######-----
######    ######
      ....      
      ....      
######....######
-----#....##   #
-----#....##   #
-----##  ###   #
#####-#  #### ##
#   ###  ##    #
#              #
#   ###  ###   #
#####-#  #-#####
------#  #------

- none
# wall
@ spiral
  floor
. rubble