16,15

## #############
## #############
## ###    ######
#               
#               
######    # ####
######    # ####
#  ###    #    #
#######  ### # #
#######  ### # #
#   ###  ##    #
##             #
##  ###  ### # #
#   ###  #######
#######  #######

# WALL
  FLOOR
. RUBBLE